//MAP CONVERTED BY dmm2tgm.py THIS HEADER COMMENT PREVENTS RECONVERSION, DO NOT REMOVE
"a" = (
/obj/terrain_modifier/climate/oceanic,
/turf/water,
/area/sea)
"b" = (
/obj/terrain_modifier/climate/oceanic,
/obj/terrain_modifier/vegetation/grass,
/obj/terrain_modifier/material/fish,
/turf/ground/plain,
/area/province/britannia/dumnonia)
"f" = (
/obj/terrain_modifier/climate/continental,
/obj/terrain_modifier/vegetation/forest,
/obj/terrain_modifier/material/grain,
/turf/ground/mountain,
/area/province/britannia/pictavia)
"h" = (
/obj/terrain_modifier/climate/oceanic,
/obj/terrain_modifier/vegetation/sparse,
/obj/terrain_modifier/material/fish,
/turf/ground/wetland,
/area/province/britannia/lloegyr)
"i" = (
/obj/terrain_modifier/climate/oceanic,
/obj/terrain_modifier/strait{
	icon_state = "strait";
	dir = 4
	},
/turf/water,
/area/sea)
"j" = (
/obj/terrain_modifier/climate/oceanic,
/obj/terrain_modifier/vegetation/sparse,
/obj/terrain_modifier/material/fish,
/turf/ground/hill,
/area/province/britannia/leathcuinn)
"k" = (
/obj/terrain_modifier/climate/oceanic,
/obj/terrain_modifier/vegetation/grass,
/obj/terrain_modifier/material/fish,
/turf/ground/hill,
/area/province/britannia/brigantia)
"m" = (
/obj/terrain_modifier/climate/oceanic,
/obj/terrain_modifier/vegetation/woods,
/obj/terrain_modifier/material/fish,
/turf/ground/hill,
/area/province/britannia/gododdin)
"o" = (
/obj/terrain_modifier/climate/oceanic,
/obj/terrain_modifier/vegetation/woods,
/obj/terrain_modifier/material/grain,
/turf/ground/plain,
/area/province/britannia/lloegyr)
"t" = (
/obj/terrain_modifier/climate/oceanic,
/obj/terrain_modifier/vegetation/grass,
/obj/terrain_modifier/material/grain,
/turf/ground/hill,
/area/province/britannia/gododdin)
"u" = (
/obj/terrain_modifier/climate/oceanic,
/obj/terrain_modifier/vegetation/grass,
/obj/terrain_modifier/material/fish,
/turf/ground/plain,
/area/province/britannia/brigantia)
"v" = (
/obj/terrain_modifier/climate/oceanic,
/obj/terrain_modifier/vegetation/sparse,
/obj/terrain_modifier/material/grain,
/turf/ground/hill,
/area/province/britannia/cymru)
"x" = (
/obj/terrain_modifier/climate/oceanic,
/turf/water/deep,
/area/sea)
"y" = (
/obj/terrain_modifier/climate/oceanic,
/obj/terrain_modifier/vegetation/grass,
/obj/terrain_modifier/material/grain,
/turf/ground/plain,
/area/province/britannia/leathcuinn)
"z" = (
/obj/terrain_modifier/climate/oceanic,
/obj/terrain_modifier/vegetation/grass,
/obj/terrain_modifier/material/fish,
/turf/ground/plain,
/area/province/britannia/gododdin)
"A" = (
/obj/terrain_modifier/climate/continental,
/obj/terrain_modifier/vegetation/woods,
/obj/terrain_modifier/material/grain,
/turf/ground/hill,
/area/province/britannia/gododdin)
"B" = (
/obj/terrain_modifier/climate/oceanic,
/obj/terrain_modifier/vegetation/grass,
/obj/terrain_modifier/material/fish,
/turf/ground/hill,
/area/province/britannia/dumnonia)
"D" = (
/obj/terrain_modifier/climate/oceanic,
/obj/terrain_modifier/vegetation/grass,
/obj/terrain_modifier/material/fish,
/turf/ground/wetland,
/area/province/britannia/leathcuinn)
"I" = (
/obj/terrain_modifier/climate/oceanic,
/obj/terrain_modifier/vegetation/grass,
/obj/terrain_modifier/material/grain,
/turf/ground/plain,
/area/province/britannia/brigantia)
"J" = (
/obj/terrain_modifier/climate/oceanic,
/obj/terrain_modifier/river{
	dir = 1
	},
/obj/terrain_modifier/vegetation/sparse,
/obj/terrain_modifier/material/grain,
/turf/ground/plain,
/area/province/britannia/leathcuinn)
"L" = (
/obj/terrain_modifier/climate/oceanic,
/obj/terrain_modifier/vegetation/sparse,
/obj/terrain_modifier/material/grain,
/turf/ground/hill,
/area/province/britannia/brigantia)
"M" = (
/obj/terrain_modifier/climate/oceanic,
/obj/terrain_modifier/vegetation/sparse,
/obj/terrain_modifier/material/fish,
/turf/ground/wetland,
/area/province/britannia/leathmoga)
"N" = (
/obj/terrain_modifier/climate/oceanic,
/obj/terrain_modifier/river{
	dir = 9
	},
/obj/terrain_modifier/vegetation/woods,
/obj/terrain_modifier/material/fish,
/turf/ground/hill,
/area/province/britannia/leathmoga)
"O" = (
/obj/terrain_modifier/climate/oceanic,
/obj/terrain_modifier/vegetation/sparse,
/obj/terrain_modifier/material/fish,
/turf/ground/hill,
/area/province/britannia/dumnonia)
"P" = (
/obj/terrain_modifier/climate/oceanic,
/obj/terrain_modifier/vegetation/grass,
/obj/terrain_modifier/material/fish,
/turf/ground/hill,
/area/province/britannia/cymru)
"Q" = (
/obj/terrain_modifier/climate/oceanic,
/obj/terrain_modifier/vegetation/woods,
/obj/terrain_modifier/material/grain,
/turf/ground/plain,
/area/province/britannia/leathmoga)
"R" = (
/obj/terrain_modifier/climate/oceanic,
/obj/terrain_modifier/river{
	dir = 8
	},
/obj/terrain_modifier/vegetation/grass,
/obj/terrain_modifier/material/grain,
/turf/ground/plain,
/area/province/britannia/lloegyr)
"S" = (
/obj/terrain_modifier/climate/oceanic,
/obj/terrain_modifier/river{
	dir = 4
	},
/obj/terrain_modifier/vegetation/grass,
/obj/terrain_modifier/material/fish,
/turf/ground/hill,
/area/province/britannia/leathmoga)
"T" = (
/obj/terrain_modifier/climate/continental,
/obj/terrain_modifier/vegetation/sparse,
/obj/terrain_modifier/material/fish,
/turf/ground/hill,
/area/province/britannia/pictavia)
"U" = (
/obj/terrain_modifier/climate/continental,
/obj/terrain_modifier/vegetation/sparse,
/obj/terrain_modifier/material/fish,
/turf/ground/mountain,
/area/province/britannia/pictavia)

(1,1,1) = {"
x
x
x
x
a
a
a
a
a
x
"}
(2,1,1) = {"
x
x
x
a
a
D
S
M
a
x
"}
(3,1,1) = {"
a
a
a
a
j
J
N
a
a
x
"}
(4,1,1) = {"
a
U
T
a
j
y
Q
a
a
a
"}
(5,1,1) = {"
a
U
f
t
i
a
a
P
O
a
"}
(6,1,1) = {"
a
a
m
t
A
I
v
v
B
a
"}
(7,1,1) = {"
a
a
a
z
k
L
o
R
b
a
"}
(8,1,1) = {"
x
x
a
a
a
u
h
R
a
a
"}
(9,1,1) = {"
x
x
x
x
a
a
h
a
a
x
"}
(10,1,1) = {"
x
x
x
x
x
a
a
a
x
x
"}
